{
    "AJ": "n1",
    "BA": "n2",
    "AB": "n3",
    "CKP1": "n4",
    "CKP2": "n5",
    "ZF": "n6",
    "GR": "n7",
    "RG": "n8",
    "JG": "n9",
    "AG": "n10",
    "GI": "n11",
    "EG": "n12",
    "EI": "n13",
    "JA": "n14",
    "KJ": "n15",
    "JJ": "n16",
    "KG": "n17",
    "RK": "n18",
    "WK": "n19",
    "KZ": "n20",
    "KK": "n21",
    "FK": "n22",
    "JK": "n23",
    "KL": "n24",
    "SL": "n25",
    "GL": "n26",
    "AL": "n27",
    "CL": "n28",
    "KM": "n29",
    "OM": "n30",
    "PM": "n31",
    "AM": "n32",
    "TM": "n33",
    "RM": "n34",
    "MI": "n35",
    "NM": "n36",
    "FN": "n37",
    "MN": "n38",
    "JO": "n39",
    "WO": "n40",
    "PP": "n41",
    "PA": "n42",
    "KP": "n43",
    "JR": "n44",
    "RA": "n45",
    "PR": "n46",
    "DR": "n47",
    "AR": "n48",
    "WR": "n49",
    "MR": "n50",
    "SU": "n51",
    "IS": "n52",
    "LS": "n53",
    "SG": "n54",
    "SE": "n55",
    "SZ": "n56",
    "WSZ": "n57",
    "EP": "n58",
    "JS": "n59",
    "AS": "n60",
    "PS": "n61",
    "DS": "n62",
    "TE": "n63",
    "JT": "n64",
    "RT": "n65",
    "WS": "n66",
    "MW": "n67",
    "WM": "n68",
    "WZ": "n69",
    "AW": "n70",
    "ZI": "n71",
    "wak3": "n72",
    "MŁ": "n73",
    "SW": "n74"
}
