{
    "AJ": "n1",
    "AB": "n2",
    "KC": "n3",
    "CKP1": "n4",
    "CKP2": "n5",
    "ZF": "n6",
    "RF": "n7",
    "GR": "n8",
    "RG": "n9",
    "JG": "n10",
    "AG": "n11",
    "GI": "n12",
    "EG": "n13",
    "EI": "n14",
    "JA": "n15",
    "MJ": "n16",
    "KJ": "n17",
    "JJ": "n18",
    "KG": "n19",
    "RK": "n20",
    "WK": "n21",
    "KZ": "n22",
    "KK": "n23",
    "SK": "n24",
    "FK": "n25",
    "JK": "n26",
    "KL": "n27",
    "GL": "n28",
    "OL": "n29",
    "AL": "n30",
    "LA": "n31",
    "CL": "n32",
    "KM": "n33",
    "OM": "n34",
    "PM": "n35",
    "AM": "n36",
    "ME": "n37",
    "RM": "n38",
    "NM": "n39",
    "FN": "n40",
    "MN": "n41",
    "JO": "n42",
    "WO": "n43",
    "PP": "n44",
    "PA": "n45",
    "JR": "n46",
    "RA": "n47",
    "DR": "n48",
    "WR": "n49",
    "MR": "n50",
    "SU": "n51",
    "IS": "n52",
    "LS": "n53",
    "SG": "n54",
    "SE": "n55",
    "SZ": "n56",
    "WSZ": "n57",
    "EP": "n58",
    "SJ": "n59",
    "AS": "n60",
    "PS": "n61",
    "MS": "n62",
    "DS": "n63",
    "TE": "n64",
    "JT": "n65",
    "MT": "n66",
    "RT": "n67",
    "WS": "n68",
    "MW": "n69",
    "WM": "n70",
    "WZ": "n71",
    "KW": "n72",
    "AW": "n73",
    "ZI": "n74",
    "MŁ": "n75",
    "SW": "n76"
}
