{
    "1A": "o1",
    "1B": "o2",
    "1C": "o3",
    "1D": "o4",
    "1E": "o5",
    "2A": "o6",
    "2B": "o7",
    "2C": "o8",
    "2D": "o9",
    "3A": "o10",
    "3B": "o11",
    "3C": "o12",
    "3D": "o13",
    "3E": "o14",
    "3F": "o15",
    "3G": "o16",
    "3H": "o17",
    "4A": "o18",
    "4B": "o19",
    "4C": "o20",
    "4D": "o21",
    "4E": "o22",
    "4F": "o23",
    "5A": "o24",
    "5B": "o25",
    "5C": "o26",
    "5D": "o27",
    "5E": "o28",
    "5F": "o29"
}
