{
    "AB": "n1",
    "AG": "n2",
    "AJ": "n3",
    "AL": "n4",
    "AM": "n5",
    "AS": "n6",
    "AW": "n7",
    "CKP1": "n8",
    "CKP2": "n9",
    "CL": "n10",
    "DR": "n11",
    "DS": "n12",
    "EG": "n13",
    "EI": "n14",
    "EP": "n15",
    "FK": "n16",
    "FN": "n17",
    "GI": "n18",
    "GL": "n19",
    "GR": "n20",
    "IS": "n21",
    "JA": "n22",
    "JG": "n23",
    "JJ": "n24",
    "JK": "n25",
    "JO": "n26",
    "JR": "n27",
    "JT": "n28",
    "KC": "n29",
    "KG": "n30",
    "KJ": "n31",
    "KK": "n32",
    "KL": "n33",
    "KM": "n34",
    "KW": "n35",
    "KZ": "n36",
    "LA": "n37",
    "LS": "n38",
    "ME": "n39",
    "MJ": "n40",
    "MN": "n41",
    "MR": "n42",
    "MS": "n43",
    "MT": "n44",
    "MW": "n45",
    "MŁ": "n46",
    "NM": "n47",
    "OL": "n48",
    "OM": "n49",
    "PA": "n50",
    "PM": "n51",
    "PP": "n52",
    "PS": "n53",
    "RA": "n54",
    "RF": "n55",
    "RG": "n56",
    "RK": "n57",
    "RM": "n58",
    "RT": "n59",
    "SE": "n60",
    "SG": "n61",
    "SJ": "n62",
    "SK": "n63",
    "SU": "n64",
    "SW": "n65",
    "SZ": "n66",
    "TE": "n67",
    "WK": "n68",
    "WM": "n69",
    "WO": "n70",
    "WR": "n71",
    "WS": "n72",
    "WSZ": "n73",
    "WZ": "n74",
    "ZF": "n75",
    "ZI": "n76"
}