{
    "1A": "o1",
    "1B": "o2",
    "1C": "o3",
    "1D": "o4",
    "2A": "o5",
    "2B": "o6",
    "2C": "o7",
    "2D": "o8",
    "2E": "o9",
    "2F": "o10",
    "2G": "o11",
    "2H": "o12",
    "3A": "o13",
    "3B": "o14",
    "3C": "o15",
    "3D": "o16",
    "3E": "o17",
    "3F": "o18",
    "4A": "o19",
    "4B": "o20",
    "4C": "o21",
    "4D": "o22",
    "4E": "o23",
    "4F": "o24",
    "5A": "o25",
    "5B": "o26",
    "5C": "o27",
    "5D": "o28",
    "5E": "o29",
    "5F": "o30",
    "5G": "o31"
}